111111111111111111111111111111111111111111111111111111111111111111111111111111111111111111111111111111111111
1001000000000000010000000000000111111111111111111111111111111100000000000001000000000000010000000000000000C1
100000011111111111111111111111111111100001111100000000011111000000000111110000000001111100000000011111111001
1P0011E00000000011E00000000011E00000000011E00000111111111111111111111111111111000011E00000000011E00000000001
111111111100000011111111110000001111111111000111111111111111111111111111111000111111111100000011111000000111
111111111111111111111111111111111111111111111111111111111111111111111111111111111111111111111111111111111111
