1111111111111111111
10010000000000000C1
1000000000011111001
1P0011E000000000001
1111111111000000111
1111111111111111111
